Sentence Endings and Constructions
そうもない (Sō mo nai): Unlikely to.
ざるを得ない (Zaru o enai): Have no choice but to.
ずにはいられない (Zu ni wa irarenai): Cannot help but.
とは限らない (To wa kagiranai): Not necessarily.
に決まっている (Ni kimatte iru): Bound to be.
とはいえ (To wa ie): Even though.
ものの (Mono no): Although.
次第だ (Shidai da): Dependent on.
にかかわらず (Ni kakawarazu): Regardless of.
わけではない (Wake de wa nai): It does not mean that.
Causality and Reason
こととて (Koto tote): Because, as.
とあって (To atte): Because of, due to.
ともなると (To mo naru to): Once (something happens).
ともあろう (To mo arou): As befitting of.
Hypotheses and Conditions
とすれば (To sureba): If, assuming.
とすると (To suru to): If, assuming.
ともあれば (To mo areba): Given that.
ともなく (Tomo naku): Without intending to.
ないではおかない (Nai de wa okanai): Cannot help but.
ないではすまない (Nai de wa sumanai): Must, have to.
Temporal and Sequential
が早いか (Ga hayai ka): As soon as.
や否や (Ya ina ya): As soon as.
が最後 (Ga saigo): Once something happens.
そばから (Soba kara): As soon as.
Degree and Extent
くらいなら (Kurai nara): If (it’s going to be).
ほどのことではない (Hodo no koto de wa nai): Not such a big deal.
にあたらない (Ni ataranai): Not worth.
かたがた (Katagata): While, at the same time.
Comparisons and Emphasis
たりとも (Tari tomo): Not even.
といったらない (To ittara nai): Extremely.
をおいて (Wo oite): Except for.
を皮切りに (Wo kawakiri ni): Starting with.
Particles and Connectives
にひきかえ (Ni hiki kae): In contrast to.
に即して (Ni sokushite): In line with.
を踏まえて (Wo fumaete): Based on.
を控えて (Wo hikaete): In preparation for.
を経て (Wo hete): Through, via.
もさることながら (Mo saru koto nagara): Not only... but also.
にして (Ni shite): Even, in.
ながらも (Nagara mo): Although.
Additional Grammar Points
に至って (Ni itatte): At the point where.
に至るまで (Ni itaru made): Up until.
に至っては (Ni itatte wa): As for.
の極み (No kiwami): The height of.
の至り (No itari): The utmost of.
を限りに (Wo kagiri ni): As of.
をもって (Wo motte): By means of.
とあれば (To areba): If.
ないものでもない (Nai mono demo nai): Not impossible.
Idiomatic Expressions and Advanced Structures
にしても (Ni shite mo): Even if.
にしては (Ni shite wa): Considering.
というところだ (To iu tokoro da): About, approximately.
ともなれば (To mo nareba): When it comes to.
ともなると (To mo naru to): When it becomes.
なり (Nari): As soon as.
なりとも (Nari tomo): Even a little.
がてら (Gatera): While, at the same time.
Formal and Literary Constructions
べからず (Bekarazu): Must not, should not.
べく (Beku): In order to.
べくもない (Beku mo nai): Cannot possibly.
に忍びない (Ni shinobi nai): Cannot bear to.
をよそに (Wo yoso ni): Despite.
たところで (Ta tokoro de): Even if.
てからというもの (Te kara to iu mono): Since.
を限りに (Wo kagiri ni): As of, starting from.
Emphasis and Focus
こそあれ (Koso are): Despite.
こそすれ (Koso sure): Though, even.
こそあれ (Koso are): Even though.
こそ...が (Koso...ga): Though, but.
にしたところで (Ni shita tokoro de): Even if.
Negative and Restrictive
ないまでも (Nai made mo): Even if not.
ないことには (Nai koto ni wa): Unless.
なしには (Nashi ni wa): Without.