Sentence Endings and Constructions
そうだ (Sō da): It is said that (hearsay).
ようだ (Yō da): It seems that, appears to be.
らしい (Rashii): Seems like, evidently.
みたいだ (Mitai da): Looks like, seems like.
まい (Mai): Will not, probably won’t.
かもしれない (Kamo shirenai): Might, may.
に違いない (Ni chigai nai): Must be, no doubt that.
はずだ (Hazuda): Should be, ought to be.
べきだ (Bekida): Should, ought to.
ことだ (Kotoda): Should, it’s important to.
ものだ (Monoda): Used to, should.
Particles and Connectives
ばかりか (Bakarika): Not only... but also.
ばかりでなく (Bakari denaku): Not only... but also.
に加えて (Ni kuwaete): In addition to.
上に (Ue ni): On top of, in addition to.
一方 (Ippō): On one hand, on the other hand.
につれて (Ni tsurete): As, in proportion to.
に伴って (Ni tomonatte): As, in proportion to.
とともに (To tomo ni): Along with, as.
に従って (Ni shitagatte): In accordance with.
に応じて (Ni ōjite): According to, in response to.
Conditions and Hypotheses
たとえ～ても (Tatoe ~temo): Even if.
もし～なら (Moshi ~nara): If.
たら (Tara): If, when.
ならば (Naraba): If.
ば (Ba): If.
ではないか (Dewa nai ka): Isn’t it? Let’s.
おかげで (Okage de): Thanks to.
せいで (Sei de): Because of (negative).
ように (Yō ni): So that, in order to.
ことになっている (Koto ni natte iru): It has been decided that.
ことにしている (Koto ni shite iru): I have decided to.
Comparisons and Degree
ほど (Hodo): To the extent that.
くらい (Kurai): To the extent that.
ぐらい (Gurai): Approximately.
だけあって (Dake atte): As expected of.
だけに (Dake ni): Precisely because.
Temporal and Sequential
ところに (Tokoro ni): Just as.
ところで (Tokoro de): Just as.
ところを (Tokoro o): Just when.
際に (Sai ni): On the occasion of.
最中に (Saichū ni): In the middle of.
に際して (Ni saishite): On the occasion of.
にあたって (Ni atatte): At the time of.
に先立って (Ni sakidatte): Before, prior to.
Causality and Reason
ために (Tame ni): Because of, due to.
によって (Ni yotte): Due to, by.
によると (Ni yoru to): According to.
からには (Kara ni wa): Since, now that.
わけにはいかない (Wake ni wa ikanai): Cannot afford to, have no choice but to.
わけがない (Wake ga nai): There’s no way that.
わけではない (Wake de wa nai): It does not mean that.
わけだ (Wake da): It means that.
Additional Grammar Points
にしては (Ni shite wa): Considering that.
にしたら (Ni shitara): From the standpoint of.
にすぎない (Ni suginai): Merely, nothing but.
にほかならない (Ni hokanaranai): Nothing but.
に対して (Ni taishite): Towards, against.
に関して (Ni kanshite): Concerning, about.
にとって (Ni totte): For.
において (Ni oite): In, at.
として (Toshite): As.
にしたがって (Ni shitagatte): In accordance with.
にわたって (Ni watatte): Throughout.
としても (Toshite mo): Even if.
としての (Toshite no): As a.
としては (Toshite wa): As for.
Expressions and Idioms
かける (Kakeru): To begin to.
つつある (Tsutsu aru): Be in the process of.
つつ (Tsutsu): While.
ぬきで (Nuki de): Without.
ぬく (Nuku): Do something to the end.
きり (Kiri): Only, just.
がち (Gachi): Tend to, often.
っぽい (Ppoi): -ish, somewhat.
たびに (Tabi ni): Every time.
たとたん (Ta totan): Just at the moment.
ようがない (Yō ga nai): There’s no way to.
Degree and Extent
限り (Kagiri): As long as.
に限り (Ni kagiri): Limited to.
に限って (Ni kagitte): Particularly when.
に限らず (Ni kagirazu): Not limited to.
Emphasis and Focus
こそ (Koso): Emphasizes preceding word.
こそあれ (Koso are): Despite, even though